PB-,PB-,PB-,PB-,PB-,PB-,PB-,PB-,PB-,PB-,PB-,PB-,PB-,PB-,PB-,PB-,PB-,PB-,PB-,PB-,PB-,PB-,PB-,PB-,PB-,PB-,PB-,PB-,PB-,PB-,PB-,PB-,PB-,PB-,PB-,PB-,PB-,PB-,PB-,PB-,PB-,PB-,PB-,PB-,PB-,PB-,PB-,PB-,---,PB-,PB-,PB-,PB-,PB-,PB-,---
---,---,---,---,---,-S-,---,---,---,---,---,---,---,---,---,---,---,---,---,---,---,---,---,---,---,---,---,---,---,---,---,---,---,---,---,---,---,---,---,---,---,---,---,---,---,---,---,---,PV-,---,---,---,---,---,---,PL-
---,---,---,---,---,-S-,---,---,---,---,---,---,---,---,---,---,---,---,---,---,---,---,---,---,---,---,---,---,---,---,---,---,---,---,---,---,---,---,---,---,---,---,---,---,---,---,---,---,PV-,---,---,---,---,---,---,PL-
---,---,---,---,---,-S-,---,---,---,---,---,---,---,---,---,---,---,---,---,---,---,---,---,---,---,---,---,---,---,---,---,---,---,---,---,---,---,---,---,---,---,---,---,---,---,---,---,---,PV-,---,---,---,---,-O-,---,PL-
---,---,---,---,---,-S-,---,---,---,---,---,---,---,---,---,---,---,---,---,---,---,---,---,---,---,---,---,---,---,---,---,---,---,---,---,---,---,---,---,---,---,---,---,---,---,---,---,---,PV-,---,---,---,---,---,---,PL-
---,---,---,---,---,-S-,---,---,---,---,---,---,---,---,---,---,---,---,---,---,---,---,---,---,-O-,---,---,---,---,---,---,---,---,---,---,---,---,---,---,---,---,---,---,PTL,PTR,---,---,---,PV-,---,---,---,---,---,---,PL-
---,---,---,---,---,-S-,---,---,---,---,---,---,---,---,---,---,---,---,---,---,---,---,---,---,---,---,---,---,---,---,---,---,---,---,---,---,---,---,---,POB,---,---,---,PL-,PR-,---,---,---,PV-,---,---,POB,---,---,---,PL-
---,---,---,---,---,-S-,---,---,---,---,---,---,---,---,---,---,---,---,---,---,---,---,POR,PH-,PH-,PH-,POL,---,---,---,---,---,---,---,---,---,---,---,---,PV-,---,---,---,PL-,PR-,---,---,---,PV-,---,---,PV-,---,---,---,PL-
---,---,---,---,---,-S-,---,---,---,---,---,---,---,---,---,---,---,---,---,---,---,---,---,---,---,---,---,---,---,---,---,---,---,---,---,---,---,---,---,PV-,---,---,---,PL-,PR-,---,---,---,POT,---,---,PV-,---,---,---,PL-
---,---,---,---,---,-S-,---,---,---,---,---,---,---,---,---,---,---,---,---,---,---,---,---,---,---,---,---,---,---,---,PTL,PH-,PH-,PH-,POL,---,---,---,---,PV-,---,-O-,---,PL-,PR-,---,---,---,---,---,---,PV-,---,---,---,PL-
---,---,---,---,---,-S-,---,---,---,---,---,---,---,---,---,---,---,---,---,---,---,---,---,---,---,---,---,---,---,---,PV-,---,---,---,---,---,---,---,---,PV-,---,---,---,PL-,PR-,---,---,---,---,---,---,PV-,---,---,---,PL-
---,---,---,---,---,-S-,---,---,---,---,---,---,---,PTL,PH-,PH-,PH-,POL,---,---,---,---,---,---,---,---,---,---,---,---,PV-,---,-O-,---,---,---,---,---,---,PV-,---,---,---,PL-,PR-,---,---,---,---,---,---,PV-,---,---,---,PL-
---,---,PC-,---,---,-S-,---,---,---,---,---,---,---,PV-,---,---,---,---,---,---,---,---,---,---,---,---,---,---,---,---,PV-,---,---,---,---,---,---,---,---,PV-,---,---,---,PL-,PR-,---,---,---,---,---,---,PV-,---,---,---,PL-
---,---,---,---,---,-S-,---,---,---,---,---,---,---,PV-,---,---,---,---,---,---,---,---,---,---,---,---,---,---,---,---,POT,---,---,---,PS-,---,---,---,---,POT,---,---,---,PLB,PRB,---,---,---,---,---,---,POT,---,---,---,PL-
---,---,---,---,---,-S-,---,---,---,---,---,---,---,PV-,---,-O-,---,---,---,---,---,---,---,---,---,---,---,---,---,---,---,---,---,---,---,---,---,---,---,---,---,---,---,---,---,---,---,---,---,---,---,---,---,---,---,PL-
PT-,PT-,PT-,PT-,PT-,PTR,---,---,---,---,---,---,---,PV-,---,---,---,---,---,---,---,---,---,---,---,---,---,---,---,---,---,---,---,---,---,---,---,---,---,---,---,---,---,---,---,---,---,---,---,---,---,---,---,---,---,PL-
PO-,PO-,PO-,PO-,PO-,PR-,---,---,---,---,---,---,---,PV-,---,---,---,---,---,---,---,---,---,---,---,---,---,---,---,---,---,---,---,---,---,---,---,---,---,---,---,---,---,---,---,---,---,---,---,---,---,---,---,---,---,PL-
PO-,PO-,PO-,PO-,PO-,PO-,PT-,PT-,PT-,PT-,PT-,PT-,PT-,PO-,PT-,PT-,PT-,PT-,PT-,PT-,PT-,PT-,PT-,PT-,PT-,PT-,PT-,PT-,PT-,PT-,PT-,PT-,PT-,PT-,PT-,PT-,PT-,PT-,PT-,PT-,PT-,PT-,PT-,PT-,PT-,PT-,PT-,PT-,PT-,PT-,PT-,PT-,PT-,PT-,PT-,---