PB-,PB-,PB-,PB-,PB-,PB-,PB-,PB-,PB-,PB-,PB-,PB-,PB-,PB-,PB-,PB-,PB-,PB-,PB-,PB-,PB-,PB-,PB-,PB-,PB-,PB-,PB-,PB-,PB-,PB-,PB-,PB-,PB-,PB-,PB-,PB-,PB-,PB-,PB-,PB-,PB-,PB-,PB-,PB-,PB-,PB-,PB-,PB-,PB-,PB-,PB-,PB-,PB-,PB-,PB-,PB-,PB-,PB-,PB-,PB-,PB-,PB-,PB-,PB-,PB-,PB-,PB-,PB-,PB-,PB-,PB-,PB-,PB-,PB-,PB-,PB-,PB-,PB-,PB-,PB-,PB-,PB-,PB-,PB-,PB-,PB-,PB-,PB-,PB-,PB-,PB-,PB-,PB-,PB-,PB-,PB-,PB-,PB-,PB-,PB-,PB-,PB-,PB-,PB-,PB-
---,---,---,---,---,---,---,---,---,---,---,---,---,---,---,---,---,---,---,---,---,---,---,---,---,---,---,---,---,---,---,---,---,---,---,---,---,---,---,---,---,---,---,---,---,---,---,---,---,---,---,---,---,---,---,---,---,---,---,---,---,---,---,---,---,---,---,---,---,---,---,---,---,---,---,---,---,---,---,---,---,---,---,---,---,---,---,---,---,---,---,---,-S-,---,---,---,---,---,---,---,---,---,---,---,---
---,---,---,---,---,---,---,---,---,---,---,---,---,---,---,---,---,---,---,---,---,---,---,---,---,---,---,---,---,---,---,---,---,---,---,---,---,---,---,---,---,---,---,---,---,---,---,---,---,---,---,---,---,---,---,---,---,---,---,---,---,---,---,---,---,---,---,---,---,---,---,---,---,---,---,---,---,---,---,---,---,---,---,---,---,---,---,---,---,---,---,---,-S-,---,---,---,---,---,---,---,---,---,---,---,---
---,---,---,-T-,---,---,---,---,---,---,---,-T-,---,---,---,---,---,---,---,---,---,---,---,-T-,---,---,---,---,---,---,---,---,---,-T-,---,---,---,---,---,---,---,---,-T-,---,---,---,---,---,---,---,---,---,-T-,---,---,---,---,---,---,---,---,-T-,---,---,---,---,---,POB,---,---,---,---,---,---,---,---,---,-T-,---,---,---,---,---,---,---,---,-T-,---,---,---,---,---,-S-,---,---,---,---,---,---,-T-,---,---,---,---,---
---,---,---,---,---,---,---,---,---,---,---,---,---,---,---,---,---,---,---,---,---,---,---,---,---,---,---,---,---,---,---,---,---,---,---,---,---,---,---,---,---,---,---,---,---,---,---,---,---,---,---,---,---,---,---,---,---,---,---,---,---,---,---,---,---,---,---,PV-,---,---,---,---,---,---,---,---,---,---,---,---,---,---,---,---,---,---,---,---,---,---,---,---,-S-,---,---,---,---,---,---,---,---,---,---,---,---
---,---,---,---,---,---,---,---,---,---,---,---,---,---,---,---,---,---,---,---,---,---,---,---,---,---,---,---,---,---,---,---,---,---,---,---,---,---,---,---,---,---,---,---,---,---,---,---,---,---,---,---,---,---,---,---,---,---,---,---,---,---,---,---,---,---,---,PV-,---,---,PTL,PTR,---,---,---,---,---,---,---,---,---,---,---,---,---,---,---,---,---,---,---,---,-S-,---,---,---,---,---,---,---,---,---,---,---,---
---,---,---,---,---,---,---,---,---,---,---,---,---,---,---,---,---,---,---,---,---,---,---,---,---,---,---,---,---,---,---,---,---,---,---,---,---,---,---,---,---,---,---,---,---,---,---,---,---,---,---,---,---,---,---,---,---,---,---,---,---,---,---,---,---,---,---,PV-,---,---,PL-,PR-,---,---,---,---,---,---,---,---,---,---,---,---,---,---,---,---,---,---,---,---,-S-,---,---,---,---,---,---,---,---,---,---,---,---
---,---,---,---,---,---,---,---,---,---,---,---,---,---,---,---,---,---,---,---,---,---,---,---,---,---,---,---,---,---,---,---,---,---,---,---,---,---,---,---,---,---,---,---,---,---,---,---,---,---,---,---,---,---,---,---,---,---,---,---,---,---,---,---,---,---,---,PV-,---,---,PL-,PR-,---,---,---,---,---,---,---,---,---,---,---,---,---,---,---,---,---,---,---,---,-S-,---,---,---,---,---,---,---,---,---,---,---,---
---,---,---,---,---,---,---,---,---,---,---,---,---,---,---,---,---,---,---,---,---,---,---,---,---,---,---,---,---,---,---,---,---,---,---,---,---,---,---,---,---,---,---,---,---,---,---,---,---,---,---,---,---,---,---,---,---,---,---,---,---,---,---,---,---,---,---,PV-,---,---,PL-,PR-,---,---,---,---,---,---,---,---,---,---,---,---,---,---,---,---,---,---,---,---,-S-,---,---,---,---,---,---,---,---,---,---,---,---
---,---,---,---,---,---,---,---,---,---,---,---,---,---,---,---,---,---,---,---,---,---,---,---,---,---,---,---,---,---,---,---,---,---,---,---,---,---,---,---,---,---,---,---,---,---,---,---,---,---,---,---,---,---,---,---,---,---,---,---,---,---,---,---,---,---,---,PV-,---,---,PL-,PR-,---,---,---,---,---,---,---,---,---,---,---,---,---,---,---,---,---,---,---,---,-S-,---,---,---,---,---,---,---,---,---,---,---,---
---,---,---,---,---,---,---,---,---,---,---,---,---,---,---,---,---,---,---,---,---,---,---,---,---,---,---,---,---,---,---,---,---,---,---,---,---,---,---,---,---,---,---,---,---,---,---,---,---,---,---,---,---,---,---,---,---,---,---,---,---,---,---,---,---,---,---,PV-,---,---,PL-,PR-,---,---,---,---,---,---,---,---,---,---,---,---,---,---,---,---,---,---,---,---,-S-,---,---,---,---,---,---,-O-,---,---,---,---,---
---,---,---,---,---,---,---,---,---,---,---,---,---,---,---,---,---,---,---,---,---,---,---,---,---,---,---,---,---,---,PTL,PT-,PT-,PTR,---,---,---,---,---,---,---,---,---,---,---,---,---,---,---,---,---,---,---,---,---,---,---,---,---,---,---,---,---,---,---,---,---,PV-,---,---,PL-,---,PT-,PT-,PT-,PT-,PT-,PT-,PT-,PT-,PT-,PT-,PT-,PT-,PT-,PT-,PT-,PT-,PT-,PT-,PT-,PT-,PTR,---,---,---,---,---,---,---,---,---,---,---,---
---,---,PC-,---,---,---,PTL,PT-,PT-,PT-,PT-,PT-,PT-,PT-,PT-,PT-,PTR,---,---,---,---,---,---,---,---,---,---,---,---,---,PL-,PO-,PO-,PR-,---,---,---,---,---,---,---,---,---,---,---,---,---,---,---,---,PTL,PT-,PT-,PT-,PTR,---,---,---,---,---,---,---,---,---,---,---,---,PV-,---,---,PL-,PO-,PO-,PO-,PO-,PO-,PO-,PO-,PO-,PO-,PO-,PO-,PO-,PO-,PO-,PO-,PO-,PO-,PO-,PO-,PO-,PO-,PR-,---,---,---,---,---,---,---,---,---,---,---,---
---,---,---,---,---,---,PL-,PO-,PO-,PO-,PO-,PO-,PO-,PO-,PO-,PO-,PR-,---,---,---,---,---,---,---,---,---,---,---,---,---,PL-,PO-,PO-,PO-,PTR,---,---,---,---,---,---,---,---,---,---,---,---,---,---,---,PL-,PO-,PO-,PO-,PR-,---,---,---,---,---,---,---,---,---,---,---,---,POT,---,---,PL-,PO-,PO-,PO-,PO-,PO-,PO-,PO-,PO-,PO-,PO-,PO-,PO-,PO-,PO-,PO-,PO-,PO-,PO-,PO-,PO-,PO-,PR-,---,---,---,---,---,---,---,---,---,---,---,---
---,---,---,---,---,---,PL-,PO-,PO-,PO-,PO-,PO-,PO-,PO-,PO-,PO-,PR-,---,---,---,---,---,---,---,---,---,---,---,---,---,PL-,PO-,PO-,PO-,PR-,---,---,---,---,---,---,---,---,---,---,---,---,---,---,---,PL-,PO-,PO-,PO-,PO-,PTR,---,---,---,---,---,---,---,---,---,---,---,---,---,---,PL-,PO-,PO-,PO-,PO-,PO-,PO-,PO-,PO-,PO-,PO-,PO-,PO-,PO-,PO-,PO-,PO-,PO-,PO-,PO-,PO-,PO-,PR-,---,---,---,---,---,---,---,---,---,---,---,---
PT-,PT-,PT-,PT-,PT-,PT-,---,PO-,PO-,PO-,PO-,PO-,PO-,PO-,PO-,PO-,PO-,PTR,---,---,---,---,---,---,---,---,---,---,---,---,PL-,PO-,PO-,PO-,PO-,PTR,---,---,---,---,---,---,---,---,---,---,---,---,---,---,PL-,PO-,PO-,PO-,PO-,PR-,---,---,---,---,---,---,---,---,---,---,---,---,---,---,PL-,PO-,PO-,PO-,PO-,PO-,PO-,PO-,PO-,PO-,PO-,PO-,PO-,PO-,PO-,PO-,PO-,PO-,PO-,PO-,PO-,PO-,---,PT-,PT-,PT-,PT-,PT-,PT-,PT-,PT-,PT-,PT-,PT-,PT-
PO-,PO-,PO-,PO-,PO-,PO-,PO-,PO-,PO-,PO-,PO-,PO-,PO-,PO-,PO-,PO-,PO-,PR-,---,---,---,---,---,---,---,---,---,---,---,---,PL-,PO-,PO-,PO-,PO-,PR-,---,---,---,---,---,---,---,---,---,---,---,---,---,---,PL-,PO-,PO-,PO-,PO-,PR-,---,---,---,---,---,---,---,---,---,---,---,---,---,---,PL-,PO-,PO-,PO-,PO-,PO-,PO-,PO-,PO-,PO-,PO-,PO-,PO-,PO-,PO-,PO-,PO-,PO-,PO-,PO-,PO-,PO-,PO-,PO-,PO-,PO-,PO-,PO-,PO-,PO-,PO-,PO-,PO-,PO-,PO-
PO-,PO-,PO-,PO-,PO-,PO-,PO-,PO-,PO-,PO-,PO-,PO-,PO-,PO-,PO-,PO-,PO-,PR-,---,---,---,---,---,---,---,---,---,---,---,---,PL-,PO-,PO-,PO-,PO-,---,PT-,PT-,PT-,PT-,PT-,PT-,PT-,PT-,PT-,PT-,PT-,PT-,PT-,PT-,PL-,PO-,PO-,PO-,PO-,---,PT-,PT-,PT-,PT-,PT-,PT-,PT-,PT-,PT-,PT-,PT-,PT-,PT-,PT-,---,PO-,PO-,PO-,PO-,PO-,PO-,PO-,PO-,PO-,PO-,PO-,PO-,PO-,PO-,PO-,PO-,PO-,PO-,PO-,PO-,PO-,PO-,PO-,PO-,PO-,PO-,PO-,PO-,PO-,PO-,PO-,PO-,PO-,PO-